1111111111
1P00000001
1000C00001
1000000EC1
1111111111