11111111111
1P00E100011
11101000011
1000000C011
11111111111