111111111
1P00000C1
110E0C111
111111111